{
  "grid": {
    "width": 12,
    "height": 8
  },
  "walls": [
    { "x": 0, "y": 1, "x'": 1, "y'": 1 },
    { "x": 0, "y": 2, "x'": 0, "y'": 3 },
    { "x": 1, "y": 2, "x'": 1, "y'": 3 },
    { "x": 2, "y": 3, "x'": 3, "y'": 3 },
    { "x": 5, "y": 6, "x'": 5, "y'": 7 },
    { "x": 1, "y": 1, "x'": 1, "y'": 2 },
    { "x": 0, "y": 5, "x'": 1, "y'": 5 },
    { "x": 4, "y": 4, "x'": 4, "y'": 5 },
    { "x": 5, "y": 4, "x'": 5, "y'": 5 },
    { "x": 6, "y": 4, "x'": 6, "y'": 5 },
    { "x": 5, "y": 4, "x'": 6, "y'": 4 },
    { "x": 8, "y": 2, "x'": 8, "y'": 3 },
    { "x": 3, "y": 7, "x'": 3, "y'": 6 },
    { "x": 6, "y": 6, "x'": 7, "y'": 6 },
    { "x": 2, "y": 9, "x'": 2, "y'": 8 },
    { "x": 9, "y": 0, "x'": 8, "y'": 0 },
    { "x": 5, "y": 3, "x'": 6, "y'": 3 },
    { "x": 4, "y": 1, "x'": 5, "y'": 1 },
    { "x": 7, "y": 4, "x'": 7, "y'": 5 },
    { "x": 2, "y": 2, "x'": 2, "y'": 3 },
    { "x": 2, "y": 1, "x'": 2, "y'": 2 },
    { "x": 0, "y": 3, "x'": 1, "y'": 3 }
  ],
  "robot": {
    "x": 0,
    "y": 0,
    "dir": 0,
    "beeperCount": 0
  },
  "beepers": [
    { "x": 0, "y": 1 },
    { "x": 0, "y": 2 },
    { "x": 1, "y": 3 },
    { "x": 2, "y": 5 },
    { "x": 4, "y": 1 },
    { "x": 3, "y": 4 },
    { "x": 5, "y": 0 },
    { "x": 6, "y": 2 },
    { "x": 2, "y": 6 },
    { "x": 1, "y": 0 },
    { "x": 9, "y": 6 }
  ]
}
